11111111111111111111111111111111111111111111111111111111111111111111111111111111
1P000000000000000000000000000000000000000000000000000000000000000000000000000001
10000000000000000000000000000000000000000000000000000000000000000000000000000001
10000000100000000000000000001000000000000001111111111111111111111111000000000001
10000000100000000000000000001000000000000000000000000000000000000001000000000001
10000000100000000000000000001000000000000000000000000000000000000001000000000001
10000000100000000000000000001000000000000000000000000000000000000001000000000001
10000000100000000000000000001000000000000000000000000000000000000001000000000001
10000000100000000000000000001000000000000000000000000000000000000001000000000001
10000000100000000C0000000000100000000000000000000000000C000000000001000000000001
10000000100000000000000000001000000000000000000000000000000000000001000000000001
10000000100000000000000000001000000000000000000000000000000000000001000000000001
10000000100000000000000000001000000000000000000000000000000000000001000000000001
10000000100000000000000000001000000000000000000000000000000000000001000000000001
10000000111111111111111111111000000000000001111111111111111111111111000000000001
10000000000000000000000000001000000000000001000000000000000000000000000000000001
10000000000000000000000000001000000000000001000000000000000000000000000000000001
10000000000000000000000000001000000000000001000000000000000000000000000000000001
10000000000000000000000000001000000000000001000000000000000000000000000000000001
10000000000000000000000000001000000000000001000000000000000000000000000000000001
100000000000000000000000000010000000000000010000000000000C0000000000000000000001
10000000000000000000000000001000000000000001000000000000000000000000000000000001
10000000000000000000000000001000000000000001000000000000000000000000000000000001
10000000000000000000000000001000000000000001000000000000000000000000000000000001
10000000000000000000000000001000000000000001000000000000000000000000000000000001
10000000000000000000000000001000000000000001111111111111111111111111000000000001
10000000000000000000000000000000000000000000000000000000000000000000000000000001
10000000000000000000000000000000000000000000000000000000000000000000000000000001
100000000000000000000000000000000000000000000000000000000000000000000000000000E1
11111111111111111111111111111111111111111111111111111111111111111111111111111111
